
111111111111111111111111111
1P0011111C000000000100000E1
100000000000000000000000001
10C000000111111C00000011111
1111000000000000000000000C1
100000000000000000000000001
111111111111111111111111111