111111111111111111111111111
1P0011111C00000000010000EC1
100000000000000000000000111
10C000000111111C00000011111
1111000000000000000000000C1
10000000000C000000000000001
111111111111111111111111111