11111
1P0C1
11E11
1C011
11111
